########.##########
########.##########
########.##########
########.##########
########.##########
........@..........
########.##########
########.##########
########.##########
########.##########
########$##########
